     ##########
     #  #     #############
 ###### # ### #           ###
 #s       #f### #########   #
 # ###### #     #       ### #
 # #    # ####### ### ###   #
 #   ####         # ###   ###
 ###    ###########     ###
   ####             #####
      ###############
