     ##########
     #  #     #############
 ###### # ### #           ###
 #s       #s### #########   #
 # #### # #     #       ### #
 # #    # ####### ### ###   #
 #   ####         # ###   ###
 ###    ###########  $  ###
   ####             #####
      ###############
